┏━━━━━━━━━━━━━━━━━━━━━┓
┃.....................┃
┃...┃....┃.┏━┛....┃...┃
┃.┏━┛....┃.┃......┗━┓.┃
┃.....┃....┃....┃.....┃
┣━┛.┏━┛..━━┛....┗━┓.┗━┫
 ...┃.......━━━...┃... 
┃.┏━┛...━━━.......┗━┓.┃
┃.....................┃
┃.....................┃
┃━━━━━━.........━━━━━━┃
┃........┏   ┓........┃
┃.━━━━━━.┃   ┃.━━━━━━.┃
 ........┃   ┃........ 
┃━━━━━━..┗━━━┛..━━━━━━┃
┃..┃...............┃..┃
┃....┃...........┃....┃
┃.....................┃
┃.━━┓.┃.━━━.....┃.┏━━.┃
┃...┃.┃.....━━━.┃.┃...┃
 .┃.┫.┃..━━┓....┃.┣.┃. 
┃.┃.┃......┃......┃.┃.┃
┃.┃.┗━┓..┃.┃....┏━┛.┃.┃
┃.┃...┃..┃.┗━┓..┃...┃.┃
┃.....................┃
┃.....................┃
┗━━━━━━━━━━━━━━━━━━━━━┛
