┏━━━━━━━━━━━━━━━━━━━━━┓
┃..........┃..........┃
┃...┃.............┃...┃
┃.┏━┛....┃...┃....┗━┓.┃
┃.....┃..┃.┃.┃..┃.....┃
┣━┛.┏━┛..┃.┃.┃..┗━┓.┗━┫
┃...┃....┃...┃....┃...┃
┃.┏━┛.............┗━┓.┃
┃..........┃..........┃
┃.....................┃
┃━━━━━━.........━━━━━━┃
┃........┏   ┓........┃
┃.━━━━━━.┃   ┃.━━━━━━.┃
┃........┃   ┃........┃
┃━━━━━━..┗━━━┛..━━━━━━┃
┃..┃...............┃..┃
┃....┃...........┃....┃
┃...┃......┃......┃...┃
┃.┃...┃.........┃...┃.┃
┃...┃....┃...┃....┃...┃
┃........┃.┃.┃........┃
┃........┃.┃.┃........┃
┃...┃....┃...┃....┃...┃
┃.┃...┃.........┃...┃.┃
┃...┃......┃......┃...┃
┗━━━┻━━━━━━━━━━━━━┻━━━┛
