┏━━━━━━━┓┏━━━━━━━┓┏━━━━━━━┓
┃.......┃┃.┃...┃.┃┃.......┃
┃.┃.┏━┛.┃┃...┃...┃┃.┗━┓.┃.┃
┃.┃.┃...┃┃.┃...┃.┃┃...┃.┃.┃
┃...┃...┃┃.┗━┳━┛.┃┃...┃...┃
┃.━━┛...┃┃.┏━┻━┓.┃┃...┗━━.┃
┃....━━━┃┃.┃...┃.┃┃━━━....┃
┃━━━....┃┃...┃...┃┃....━━━┃
┃.......┃┃.┃...┃.┃┃.......┃
┗━━━━━━━┛┗━━━━━━━┛┗━━━━━━━┛
┏━━━━━━━┓┏━━━━━━━┓┏━━━━━━━┓
┃.......┃┃.......┃┃.......┃
┃━━━━━━.┃┃.......┃┃.━━━━━━┃
┃.......┃┃.┏   ┓.┃┃.......┃
┃.━━━━━━┃┃.┃   ┃.┃┃━━━━━━.┃
┃.......┃┃.┃   ┃.┃┃.......┃
┃━━━━━━.┃┃.┗━━━┛.┃┃.━━━━━━┃
┃..┃....┃┃.......┃┃....┃..┃
┃....┃..┃┃.......┃┃..┃....┃
┗━━━━━━━┛┗━━━━━━━┛┗━━━━━━━┛
┏━━━━━━━┓┏━━━━━━━┓┏━━━━━━━┓
┃.......┃┃.┃...┃.┃┃.......┃
┃.┗━┓...┃┃...┃...┃┃...┏━┛.┃
┃...┃...┃┃.┃...┃.┃┃...┃...┃
┣━┓.┗━┓.┃┃.┗━┳━┛.┃┃.┏━┛.┏━┫
┃.....┃.┃┃.┏━┻━┓.┃┃.┃.....┃
┃.┗━┓...┃┃.┃...┃.┃┃...┏━┛.┃
┃...┃...┃┃...┃...┃┃...┃...┃
┃.......┃┃.┃...┃.┃┃.......┃
┗━━━━━━━┛┗━━━━━━━┛┗━━━━━━━┛
