┏━━━━━━━┓
┃..┃....┃
┃..┃..┃.┃
┃..┗┓.┃.┃
┃...┗┓..┃
┃..┃.┃..┃
┃..┃....┃
┃....┃..┃
┃..┃....┃
┗━━━━━━━┛