┏━━━━━━━┓
┃...┃...┃
┃.┏...┓.┃
┃.┃...┃.┃
┃.┃.┃.┃.┃
┃.┃.┃.┃.┃
┃.┃...┃.┃
┃.┗...┛.┃
┃...┃...┃
┗━━━━━━━┛