┏━━━━━━━┓
┃.......┃
┃...┃...┃
┃.┏━┛...┃
┃.....┃.┃
┣━┛.┏━┛.┃
┃...┃...┃
┃.┏━┛...┃
┃.......┃
┗━━━━━━━┛
