┏━━━━━━━┓
┃.......┃
┃.┃...┃.┃
┃.┃.┏━┛.┃
┃.┃.┃...┃
┃.┃.┫.┃.┃
┃...┃.┃.┃
┃.━━┛.┃.┃
┃.......┃
┗━━━━━━━┛
