┏━━━━━━━┓
┃.......┃
┃.┃.┏━┛.┃
┃.┃.┃...┃
┃...┃...┃
┃.━━┛...┃
┃....━━━┃
┃━━━....┃
┃.......┃
┗━━━━━━━┛