┏━━━━━━━┓
┃...┃...┃
┃.......┃
┃.┃...┃.┃
┃.┃.┃.┃.┃
┃.┃.┃.┃.┃
┃.┃...┃.┃
┃.......┃
┃...┃...┃
┗━━━━━━━┛