┏━━━┳━━━┓
┃...┃...┃
┃.┃...┃.┃
┃...┃...┃
┃.......┃
┃.......┃
┃...┃...┃
┃.┃...┃.┃
┃...┃...┃
┗━━━┻━━━┛