┏━━━━━━━┓
┃.┃...┃.┃
┃...┃...┃
┃.┃...┃.┃
┃.┗━┳━┛.┃
┃.┏━┻━┓.┃
┃.┃...┃.┃
┃...┃...┃
┃.┃...┃.┃
┗━━━━━━━┛