┏━━━━━━━┓
┃.......┃
┃.┏   ┓.┃
┃.┃   ┃.┃
┃.┃   ┃.┃
┃.┃   ┃.┃
┃.┃   ┃.┃
┃.┗━━━┛.┃
┃.......┃
┗━━━━━━━┛