┏━━━━━━━┓
┃.......┃
┃.......┃
┃.......┃
┃.......┃
┃.......┃
┃.......┃
┃.......┃
┃.......┃
┗━━━━━━━┛