┏━━━━━━━┓
┃.......┃
┃━━━━━━.┃
┃.......┃
┃.━━━━━━┃
┃.......┃
┃━━━━━━.┃
┃..┃....┃
┃....┃..┃
┗━━━━━━━┛